255 0 255
20
7
1 1 0 0 1 0 1
1 1 2 1 2 2 2
6
1 1 1 0 1 1 1
2 2 2 1 1 1 1
6
0 0 1 1 1 1 1
2 2 2 2 1 1 1
5
1 1 1 1 1 1 1
1 1 2 1 1 2 2
6
1 1 1 1 0 1 1
2 1 2 1 2 1 2
1
1 1 1 1 1 1 1
2 2 1 2 2 1 1
6
1 1 0 1 1 1 1
2 2 2 2 1 1 1